000000000000000000000000000000000000000000000000
000000000000000000000000000000000000000000000000
001100000000001100011111111110001111000000001100
001100000000001100000001100000001100110000001100
001100000000001100000001100000001100001100001100
001100001100001100000001100000001100001100001100
001100001100001100000001100000001100001100001100
001100001100001100000001100000001100000011001100
000011110011110000011111111110001100000000111100
000000000000000000000000000000000000000000000000
000000000000000000000000000000000000000000000000